*###########################*
#                           #
#                           #
#                           #
#                           #
#                           #
#                           #
#                           #
#                           #
#                           #
#                           #
#                           #
#                           #
#                           #
#                           #
#                           #
#                           #
#                           #
#                           #
#                           #
#                           #
#                           #
#                #*#########*
#                 # # # # # #
#                 # : : : : #
#                 # . . . . #
#                 #   . .   #
*#############*###*#        #
# : : : : : : # # #         #
# : . . . . : # : :         #
# . .     . . # . .         #
# .         . # .           #
# .         . #             #
#             #             #
#             #             #
# ^       @ ^ #           . #
*#############*#        . . #
# # # # # # # #         : : #
*#############*#############*
