*###########################*
#                           #
#                           #
#                           #
#                           #
#                           #
#                           #
#                           #
#                           #
#                           #
#                           #
#                           #
#                           #
#                           #
#                           #
#                           #
#                           #
#                           #
#                           #
#                           #
#                           #
#                           #
#                #*#########*
#                 # # # # # #
#               b # : : : : #
#                 # . . . . #
#                 #   . .   #
*#############*###*#        #
# : : : : : : # # #         #
# : . . . . : # : :         #
# . .     . . # . .         #
# .         . # .           #
# .         . #             #
#             #             #
#             #         @   #
#  ^       1  #           . #
*#############*#        . . #
# # # # # # # #   a     : : #
*#############*#############*
