*###########################*
#                           #
#                           #
#                           #
#                           #
#                           #
#                           #
#                           #
#                           #
#                           #
#                           #
#                           #
#                           #
#                           #
#                           #
#                           #
#                           #
#                           #
#                           #
#                           #
#                           #
#                           #
#                           #
#                           #
#                           #
#                           #
#                           #
#                           #
#                           #
#                           #
#                           #
#                           #
#                           #
#                           #
#                           #
#                           #
#                           #
#  a 1 b " ^ @ ~ ' l 6 k    #
*###########################*
