*###################*#######*
#                   #       #
#             a ' ^ #       #
#            *######*  -*#- #
#      b     # # # #    #   #
#  -####-    #          #   #
#   # #     1#          #   #
#   ### ##-##*-########=*   #
#   *                       #
#                           #
#                           #
#                           #
#d  *                       #
*#*=-                   -#*#*
# # ^ @               !   # #
# ######*#=-     --#*###### #
*#*    #-           -#    *#*
# -#  #-  #          -#  #- #
#  -# #  h#         4~# #-  #
#   -#- -#*         -###*   #
#   ^#                 #    #
#  -##                 #    #
#2   #           m     #  ^ #
*##=#-          -*-    -#-# *
# # #                   #   #
#   #     *         g 3 #  f#
#   #     #        -####* -#*
#   #7 " ^#            -#   #
#   *#####*=            #   #
#c k#-                  #   #
*###*                   *=#-*
# # #                   # # #
#   #                   #   #
#   #                   #   #
#   #        #=#        #   #
#   #n                e #   #
#   *######=#*-*########*   #
#  6# # # # #   # # # # # l #
*###*###################*##=*
