#############################
#                           #
#                           #
#                           #
#                           #
#                           #
#                           #
#                           #
#                           #
#                           #
#                           #
#                           #
#                           #
#                           #
#                           #
#                           #
#                           #
#                           #
#                           #
#                           #
#                           #
#                           #
#                ############
#                 # # # # # #
#                 #         #
#                 #         #
#                 #         #
###################         #
#             # # #         #
#             #             #
#             #             #
#             #             #
#             #             #
#             #             #
#             #             #
#             #         @   #
################            #
# # # # # # # #             #
#############################
