#############################
#                           #
#                           #
#                           #
#                           #
#                           #
#                           #
#                           #
#                           #
#                           #
#                           #
#                           #
#                           #
#                           #
#                           #
#                           #
#                           #
#                           #
#                           #
#                           #
#                           #
#                           #
#                           #
#                           #
#                           #
#                           #
#                           #
#                           #
#                 ###########
#                 # # # # # #
#                 #         #
###################         #
#             # # #         #
#             #             #
#             #             #
#             #         @   #
###############             #
# # # # # # # #             #
#############################