*###*#####*#######*#####*###*
#*# #*#-# # - - - # #-#*# #*#
# #*# #               # #*# #
#*# # -               - # #*#
# #*#                   #*# #
#*# #                   # #*#
# # #                   # # #
#*#    *          -#      #*#
# #   -#           #      # #
###    #           #      ###
# #    #     ##*-  ###    # #
###    #    #- #   # -#   ###
# #    #    #  #   #  #   # #
###    #    #  #   #  #   ###
# # . ### *  #-#   *##- . # #
#-# .                   . #-#
# # :                   : # #
# *-## .             . ##-* #
# # -# . .         . . #- # #
# :  # : :  .   .  : : #  : #
# .  *###-# :   : #-###*  . #
# .  :  --*###=###*--  :  . #
#    .    : : : : :    .    #
*##=###-  . . . . .  -###=##*
#-  :       . . .       :  -#
#   .         @         .   #
# .     #-#########-#     . #
# .     #--: : : :--#     . #
# :  -##*  . . . .  *##-  : #
*#-    .     . .     .    -#*
#:     .             .     :#
#.     :             :     .#
#.-=#-#################-#=-.#
#     : : : ----- : : :     #
# .   . . .       . . .   . #
# . .     .       .     . . #
# : :                   : : #
##--#                   #--##       !
*###*=#################=*###*
