*###*#####*#######*#####*###*
#*# #*#~# # ~ ~ ~ # #~#*# #*#
# #*# #               # #*# #
#*# # ~               ~ # #*#
# #*#                   #*# #
#*# #                   # #*#
# # #                   # # #
#*#    *          ~#      #*#
# #   ~#           #      # #
###    #           #      ###
# #    #     ##*~  ###    # #
###    #    #~ #   # ~#   ###
# #    #    #  #   #  #   # #
###    #    #  #   #  #   ###
# # . ### *  #~#   *##~ . # #
#~# .                   . #~#
# # :                   : # #
# *### .             . ###* #
# # ~# . .         . . #~ # #
# :  # : :  .   .  : : #  : #
# .  *###~# : . : #~###*  . #
# .  :  ~~*#######*~~  :  . #
#    .    : : : : :    .    #
*##~###~  . . . . .  ~###~##*
#~  :       . . .       :  ~#
#   .         @         .   #
# .     #~#########~#     . #
# .     #~~: : : :~~#     . #
# :  ~##*  . . . .  *##~  : #
*#~    .     . .     .    ~#*
#:     .             .     :#
#.     : |    |    | :     .#
#.~=#~#################~#=~.#
#     : : : ~~~~~ : : :     #
# .   . . .       . . .   . #
# . .     .       .     . . #
# : :                   : : #
##~~#    |    |    |    #~~##       !
*###*=#################=*###*
