*###*#####*#######*#####*###*
#*# #*#-# # - - - # #-#*# #*#
# #*# #               # #*# #
#*# # -               - # #*#
# #*#                   #*# #
#*# #                   # #*#
# # #                   # # #
#*#                       #*#
# #                       # #
###                       ###
# #                       # #
###                       ###
# #                       # #
###                       ###
# # .                   . # #
#-# .                   . #-#
# # :                   : # #
# *### .             . ###* #
# # -# . .         . . #- # #
# :  # : :  .   .  : : #  : #
# .  *###-# : . : #-###*  . #
# .  :  --*#######*--  :  . #
#    .    : : : : :    .    #
*##-###-  . . . . .  -###-##*
#-  :       . . .       :  -#
#   .         @         .   #
# .     #-#########-#     . #
# .     #--: : : :--#     . #
# :  -##*  . . . .  *##-  : #
*#-    .     . .     .    -#*
#:     .             .     :#
#.     :             :     .#
#.-=#-#################-#=-.#
#     : : : ----- : : :     #
# .   . . .       . . .   . #
# . .     .       .     . . #
# : :                   : : #
##--#                   #--##
*###*=#################=*###*
